%%%%%%%%%%%%%%%%%%%%%%%%%%%%%%%%%%%%%
%                     %P            %
%                     %             %
%                     %             %
%                     %             %
%                     %             %
%                     %%%%%%        %
%                          %        %
%     %%%%                 %        %
%        %                 %        %
%        %                 %        %
%        %                 %        %
%        %%%%%%%%%%%%               %
%        %                          %
%        %                          %
%        %                          %
%        %                          %
%        %                          %
%       *%                          %
%%%%%%%%%%%%%%%%%%%%%%%%%%%%%%%%%%%%%